apothecaries: isaiah assigny strafford compendium calamy obadiah_blagrave tridentine simon_miller williams_hosier surgeons
apothecary: regium oil_corn chocolate drop soft bay_cadiz gems forests alum tapetry
atrophy: voluntatem inditon county_tyrone extorions ampthil terriblenes osiris dextra presaging ruiners
bad: bulk beget fail raiing_coin spend raising_coin serve arise eteem idle
bezoar: anniverary fuees reginaldus capuchines whipering lassets remedies_peculiar hebraica inagar marle
bleed: franchises casting deliveries evidenced ubdues ocular senators holders vital disdain
bleeding: prince_rupert whitehal nephews jutinian estrange caligula advancements terrors accurately justifying
blood: glorious military temper terror born fortune yoke passions barbarous valour
body: courage strength wisdom health reputation influence widom happiness suffer motion
brain: lords_prayer regeneration lex_talionis oley thorowgood thomas_watson swift parker_cornhill sibbs apostasy
breathing: speaks secures tyrannosaur traveller severely assent postscript vassals oppreing bond_void
canker: joretara robrs robert_needham hiragonisticon incision intrude ioyntenants galls ioint waked
circulate: mortgages value_gold monied_men money_pecie rein overplus specie money_specie presently banker
circulation: quick intercoure begets conceal impoverish calculate riches_plenty shou answer_ends gainer
cold: mangos soft maturity distills stem shoals ban ashes boiled inches
constitution: contitution admit right_subject established continuance establishment expedient wrong dissolution requisite
corpora: ben_irael calv tenets printers divers_select caua pronounc conf aembly_divines duck
corpus: loved recuants amidt latitat vanishes unfortunate_accident toolbar spectacle nii strong_enough
cough: crimen ipsi legibus ridley antichrit verbum concessa tenets reign_charles pars
cure: disease dark deliberations attention prudence invention discern harder universal eye
cured: dikes ditempers inulted aiaticks lien transplanted catile trove consisted catered
dead: perceiving using becomes_establish learnt cherish obervation necessities husbands meanest callings
death: romans reign_doom eng reigned_years wicked holy bloody blessed emperor britains
decay: contant fire_london tools annoy seamen_navigation neglected tolerable usurers uurers perwade
decay: contant fire_london tools annoy seamen_navigation neglected tolerable usurers uurers perwade
deceased: hopital earl_carlisle lengthier dorchester scuffle succinctly ecclesiastical_polity abrupter behaviours lucas
defect: maintain_action speaker print contruction declares proceeding debated warranted authorities dissolution
degenerate: primarily formidable ubjected monarchs greatness_mind councellors local paions mieries weal
destroy: surely preferred leads clearly appearing jealouie helps thinking morally maxim
disease: deliberations discern vice harder ignorance invention attention dark false profession
dissolution: dissolved majesty_pleased dissolve confirmation submission entruted arguments_offered adventurer administration right_subject
distemper: pest possessors agriculture aversion bloody_wars illutrious south_west tempest launch pompey
drinks: st_domingo ordnance placa meats wheat_barley paintings clay perpetuary bever pulp
dry: small_wares bras wax finer beef thread pretty ivory grows flax
dying: lace iron_steel hair laces ivory country_abounding lead_tin belly great_tore hats_paper
envy: draws lay_foundation prove_hinderance idle_drones wrest weakening ports_mediterranean coveted reject easing
exercise: municipal invade municipal_laws punih overthrown felony prerogatives exercised juridiction liberties_properties
faculties: condemnations princes_potentates advertisement marted admitted_sit hall_deire mercatoriam peculiar_province minitry wagers
fatal: peaceable negotiations allies cast suffered overthrown mutual politic_body conquered ubjected
fatality: proclaiming urgency lessening delivering desirable diappointed top_currency covetounes genuine eaie_rate
fever: lizard spout commodiously wiltshire bars harsh cloth_worker dexterity consumptions vanih
fog: big_enough foot_half pretexts fore_heads apect stifle ho swarm enclosed mists
healthy: sent_ambassadors poisoned oory dissolves temporal_eternal tread thunder_lightning threats hits mas
heart: glorious temper passions watch valour virtues fortune pride rage profess
herb: honey_wax boards camphor ananas prunes dates petticoats oranges_lemons chairs salmon
herbs: apothecary thick africans covers catching climes soft legs iva chocolate
hot: beer_ale john_hoy port_sonaly arriving pinnace riding_harbour boat city_curate goa_chap amoy
illness: adviatur_dies tartles vaire amouki ulick accompany charitable_union againthe apud_cantabrigienses andover
impairment: jealouies jealousies etimate course_living direpute bode anwer_objection accomplish ill_consequences debaing
insane: eccleiaticks zealouly generouly counellors assurances ingratiate ecclesiastics nests decribe patrons
jealousy: gratify serve preferred necessarily helps jealouie governs indutrious shou lodg
languish: stinking shelves nourishment shameful dicretion tempestuous bear_charge suckers fickle wholesome
leech: stoiei quickwood harpole willis_practice executionem_virus bride aranwhez law cozen riiel
leeches: james_proclamation cabinet pastoral corrected gangrene stub shveral lord_herbert superscribed replies_defences
liver: chastity acute inoffensive calm_peaceable malignity arrogance wrath extremes disguise adulterers
medicine: token_children isaiah davis_oxford everard_maynwaring scarborough_spew hayward_supremacy indwelling calamy hooker seventh_sabbath
medicines: resembling whereof_fully raisins juice pacious verdigris carthagena raiins brussels terra_firm
melancholy: composition thing_else strip better_success princes_sovereigns diminishing hid concluions honetly ignal
mind: methinks prudence folly tender expedients justly sure willingly perhaps piety
moist: normandy_brittany effect_nevertheless refrehment raiment ecclesiastics divertisement beholding sleeps impossibility tempestuous
mortal: eat_bread stomach grave parsimony humane_life violence_rapine shalt disguise wounds harmony
mortality: bowl curses descended exercises rudeness disturbance retirement taken_pains eminence buffoons
mouth: shores abounding ocean mouth_river winds ituate continent gulf mexico eated
nerves: secrecy familiarity ventilated ambitious stupendous disguise liver extremes moral_divine wounds
opium: wrapped perpets husk bodice comes_maturity annoyed fruit_trees diet_bread groves scylla
patient: dicouring fairer withstood milder maintain_traffic code shamefully moves dictated inconsiderate
patients: spreads palate idlers carelessly dress breasts infecting child_bed companions debaeth
phyician: small_pox knees good_luck tumultuously creep succours issachar horror brighter sent_ambassadors
phyicians: disparity disparagement sounds disappointed customary ale_coppers hardest imminent_danger securely russians
physician: midwives fables spencer_hickman eliz_calvert israels egyptian lily faithfully_translated perfumes sculptures
physicians: instrument directory acquaintance profane_swearing symptoms impieties misrule mystical disguise everlasting
plague: battles tribes slew british egbert east_angles prophecy west_saxons conspiracy lieutenant
plague: battles tribes slew british egbert east_angles prophecy west_saxons conspiracy lieutenant
pox: osred shield objection_answered civil_eccleiatical lorraign involve boiterous oswick garrioned struggling
putrid: portuguesethe strangford_tuam duan philippin cape_gratify joyriders marcelli annotationibus quieter hollander
putrid: portuguesethe strangford_tuam duan philippin cape_gratify joyriders marcelli annotationibus quieter hollander
remedies: vulgar tacitus explication virtuous intricate_subject civilians errors simplicity_original racks root
remedy: calculated avoid liable evils community contrived whoever feared intend propose
sana: agrippa polluted preparing_medicines orchards diet_physic excommunicated prisons reed vipers curiously
sick: misers conditionsfrom gallantry tanding_army virtuelove threatened qualities_degrees wiet lewd fearful
sickness: resented mercenary undermine favourite_pleaure counsellor compos oppressing reclaiming flagitious israelites
smells: vapours lyon elements equinoctial chariots deolations shower grease salt_water satin
smoke: dates foxes havana deer bay_cadiz terra_firm oranges_lemons goats corral vinegar
sores: fester beauties hot_cold padding consolation flowing thirst enforce paint dispens
spirit: minds temper heathens temperance rage glorious virtuous worship passions profess
spoil: contets flourished successively way_living impoverishing dihonour acquisitions themelves_maters footing regaining
spoiling: lives_etates years_flourihing free_paage japonians lands_revenues arrayed husball outed ceae builded
stomach: breat disguise wears breast leprosy suffices dazzled richness shoulders defenders
supple: potet heraclitus penitents inre arcane quakerism team barton propheies ephesians
surgeon: quinquina vigogne snuff limes allom minerals mountain gums oranges_lemons alkermes
surgeons: robert_clavel sacrament_lords clavel_britain calamy lily breathings making_medicines twenty_fours billingsley midwives
swelling: wast cruelties homely division fortifying sitted themoneys harvest stretched chest
ulcer: drought solomons leagues_distance hawk fevers lot_ight swept stakes coat_cormandel cherry_island
unhealthy: intelligible_greater labourers fashions spinsters cultivate expansiveness pulse scarcity_poverty labour_industry artists
unwholesome: brook booty divers_places poisoning fishermen victors peron_quality mosques watered apartheid
vein: total_connaght perfect_reconciliation taunts foot_thickness clepsydra occasined dtchess lording wittals paylet
vein: total_connaght perfect_reconciliation taunts foot_thickness clepsydra occasined dtchess lording wittals paylet
vessels: veels curated cadiz suratte harbour paage lisbon arrival fort passage
vice: disease virtuous tacitus diseases profess attention fountain valour passions temperance
vita: lord_saviour wilkinson libri temple_bar nath_ponder passenger_london winterton_price putt bradshaw john_crossly
vital: cannot_imagin undermining comprehending succour intruding rigour discoursing defamations bleed queens
vitiation: external_communion confet peeve_obedience observat maintain_internal prelats tenets anglia civility deceptions
vomit: fore_heads singing compaion ambrosius breats ou frigidity spur kind_providence players
waste: comparatively fast quantity_gold ounces yards_cloth rises likely_grow carcity impropriety consum
wasting: merchant_goldsmith filth live_comfortably jostle peacock provide_effects unspeakable circulate_amongst scarcity_poverty spends
wholesome: heats lazier angling artists shelves languish cunninger inventions handsome tents
zodiac: vice_effeminates laboriously protrate_themelves froward beggary procreation unfits carmen faithless agriculture
